20 20
4 0
15 19
#####+##############
#####+++############
####++#+##+++++#####
####+##+##+#########
+++++#+++++#+++++###
##+#########+###+###
#++++##++++++###+###
####+##+########+###
####++++###+++++++##
####+###############
####++++++##########
#####+##############
###+++##############
####+#####+++++#####
####++++####+#######
#######+++++++++++++
##########+#########
######+++++++#######
#######+####+#######
######+++###+++#####
