10 10
10 0
4 19
#####++++#
##########
##+##+#+##
######+#+#
#####++#+#
#######+##
#####++++#
##########
##+##+#+##
##########
